NO textures/texture0.xpm
SO textures/texture1.xpm
EA textures/texture2.xpm
WE textures/texture3.xpm

F 220,100,0
C 225,30,0



11111111111111111111111111111
10000000000011111000000001001
1000000000001   1000000000001
10000000000011111000000000001
1000000000000000000111E000001
11111111111111111111 11111111
