NO textures/texture0.xpm
SO textures/texture1.xpm
EA textures/texture2.xpm
WE textures/texture3.xpm

F 0,76,153
C 128,128,128

1111111111
1000000001
1000000001111
1000000000001
10000W0000001
1000000001111
1000000001
1000000111
10000001
10000001
10000001
1000000111
1000000001
1000000001
1000000001
1111111111
