EA ./path_east_texture
NO ./path_north_texture

WE ./path_west_texture

F 220,100,0

SO ./path_south_texture

C 225,30,0

   11111111
   10010001
1111000000111111
1000000000000001
11100N0011110001
  1000001  10001
  1111111  11111
