NO textures/texture0.xpm
SO textures/texture1.xpm
EA textures/texture2.xpm
WE textures/texture3.xpm

F 220,100,0
C 225,30,0

   11111111
   10010001
1111000S00111111
1000000000000001
1110000011110001
  1000001  10001
  1111111  11111
