EA ./path_east_texture
NO ./path_north_texture

WE ./path_west_texture

F 220,100,0

SO ./path_south_texture

C 225,30,0

   11111111
   10010001
11110000001
10000000001
11100N00111
  1000001
  1111111
